 -----------------------
|...........|...........|
|.|-------|.|----|----|.|
|.|..............|....|.|
|.|.|---------------|.|.|
|-|.|...............|...|
|...|.|-|.|-------|.|.|.|
|.|.|.|....##|----|.|.|.|
|.|.|.|.|-|##|..|--..--.|
|.|-|.|...|--|.....|....|
|.|.|---|.|----|...|..|.|
|.|...................|.|
|.|--------------------.|
|.......................|
 -----------------------